{
  "0": "科技",
  "1": "体育",
  "2": "娱乐",
  "3": "财经",
  "4": "社会",
  "5": "政治"
}